0 0 0 0 0 0 0 0 0 0 0 1 1 1 5 0
0 0 0 0 0 1 1 1 5 0 0 0 8 0 0 0
0 0 1 1 1 0 8 0 0 0 0 0 0 0 0 0
0 0 0 8 0 0 0 0 0 0 3 0 0 0 0 3
0 0 0 0 0 0 0 0 0 0 0 0 0 0 0 0
0 0 0 0 0 0 0 0 0 0 0 5 0 0 0 0
0 0 0 0 0 0 0 0 0 0 1 1 1 0 0 0
0 0 0 1 1 1 1 3 0 0 0 0 5 0 0 0
0 0 0 0 8 0 0 0 0 0 0 1 1 0 0 0
0 0 0 0 0 0 0 0 0 0 0 0 3 0 0 0
0 0 0 0 0 0 0 0 0 0 0 0 0 0 0 0
0 0 0 0 5 0 0 0 0 0 0 5 0 0 0 0
